---------------------
    |       |       |
-   -   -   -----   -
|       |   |       |
---------   -   -   -
|       |       |   |
-   -   ---------   -
|   |           |   |
-   -   ---------   -
|   |                
---------------------
